16
16
AAAAAAAAAAAAAAAA
ABR............A
A..............A
A.......R......A
A.......B......A
A.....RBRBRBRB.A
A.....B..B..B..A
A...........R..A
A.....B.....B..A
A...RBRBR..BR..A
A....R.........A
A....B......B..A
A....RBR...BR..A
A....B.........A
A..............A
AAAAAAAAAAAAAAAA